{
  "mapData": {
    "options": [{
      "rows": 12,
      "totalColumns": 7,
      "totalLayers": 2
    }],
    "layer0": {
      "mapDesign": [
        ["F","F","F","F","F","D","D","F","F","F","F","F"],
        ["F","F","F","F","F","F","F","F","F","F","F","F"],
        ["F","F","F","F","F","F","F","F","F","F","F","F"],
        ["F","F","F","F","F","F","F","F","F","F","F","F"],
        ["F","F","F","F","F","F","F","F","F","F","F","F"],
        ["F","F","F","F","F","F","F","F","F","F","F","F"],
        ["F","F","F","F","F","F","F","F","F","F","F","F"]
      ]
    },
    "layer1": {
      "mapDesign": [
        ["W","W","W","W","W"," "," ","W","W","W","W","W"],
        ["W"," "," "," "," "," "," "," "," "," "," ","W"],
        ["W"," "," "," "," "," "," "," "," "," "," ","W"],
        ["W"," "," "," "," ","P"," "," "," "," "," ","W"],
        ["W"," "," "," "," "," "," "," "," "," "," ","W"],
        ["W"," "," "," "," "," "," "," "," "," "," ","W"],
        ["W","W","W","W","W","W","W","W","W","W","W","W"]
      ]
    }
  }
}